40 40 40 40 40 40 40 40 40 40 40 40 40 40 40 40 40 40 40 40 40 40 40 40 40 40 40 40 40 40 40 40 40 40 40 40 40 40 40 40 40 40 40 40 40 40 40 40 40 40 40 40 40 40 40 40 40 40 40 40 40 40 40 40 40 40 40 40 40 40 40 40 40 40 40 40 40 40 40 40 40 40 40 40 40 40 40 40 40 40 40 40 40 40 40 40 40 40 40 
40 40 40 40 40 40 40 40 40 40 40 40 40 40 40 40 40 40 40 40 40 40 40 40 40 40 40 40 40 40 40 40 40 40 40 40 40 40 40 40 40 40 40 40 40 40 40 40 40 40 40 40 40 40 40 40 40 40 40 40 40 40 40 40 40 40 40 40 40 40 40 40 40 40 40 40 40 40 40 40 40 40 40 40 40 40 40 40 40 40 40 40 40 40 40 40 40 40 40 
40 40 2 2 2 2 2 2 2 2 2 2 2 2 2 2 2 2 2 2 2 2 2 2 2 2 2 2 2 2 2 2 2 2 2 2 2 12 12 12 12 12 12 12 12 12 12 12 12 12 13 13 13 13 13 13 13 13 13 13 13 13 13 13 13 13 13 13 13 13 13 13 13 13 13 13 13 13 13 13 13 13 13 13 13 13 13 13 13 13 13 13 13 13 22 22 22 22 22 
40 40 2 2 2 2 2 2 2 2 2 2 2 2 2 2 2 2 2 2 2 2 2 2 2 2 2 2 2 2 2 2 2 2 2 2 2 12 12 12 12 12 12 12 12 12 12 12 12 12 13 13 13 13 13 13 13 13 13 13 13 13 13 13 13 13 13 13 13 13 13 13 13 13 13 13 13 13 13 13 13 13 13 13 13 13 13 13 13 13 13 13 13 13 22 22 22 22 22 
40 40 2 2 2 2 2 2 2 2 2 2 2 2 2 2 2 2 2 2 2 2 2 2 2 2 2 2 2 2 2 2 2 2 2 2 2 12 12 12 12 12 12 12 12 12 12 12 12 12 13 13 13 13 13 13 13 13 13 13 13 13 13 13 13 13 13 13 13 13 13 13 13 13 13 13 13 13 13 13 13 13 13 13 13 13 13 13 13 13 13 13 13 13 22 22 22 22 22 
40 40 2 2 2 2 2 2 2 2 2 2 2 2 2 2 2 2 2 2 2 2 2 2 2 2 2 2 2 2 2 2 2 2 2 2 2 12 12 12 12 12 12 12 12 12 12 12 12 12 13 13 13 13 13 13 13 13 13 13 13 13 13 13 13 13 13 13 13 13 13 13 13 13 13 13 13 13 13 13 13 13 13 13 13 13 13 13 13 13 13 13 13 13 22 22 22 22 22 
40 40 2 2 2 2 2 2 2 2 2 2 2 2 2 2 2 2 2 2 2 2 2 2 2 2 2 2 2 2 2 2 2 2 2 2 2 12 12 12 12 12 12 12 12 12 12 12 12 12 13 13 13 13 13 13 13 13 13 13 13 13 13 13 13 13 13 13 13 13 13 13 13 13 13 13 13 13 13 13 13 13 13 13 13 13 13 13 13 13 13 13 13 13 22 22 22 22 22 
40 40 2 2 2 2 2 2 2 2 2 2 2 2 2 2 2 2 2 2 2 2 2 2 2 2 2 2 2 2 2 2 2 2 2 2 2 12 12 12 12 12 12 12 12 12 12 12 12 12 13 13 13 13 13 13 13 13 13 13 13 13 13 13 13 13 13 13 13 13 13 13 13 13 13 13 13 13 13 13 13 13 13 13 13 13 13 13 13 13 13 13 13 13 22 22 22 22 22 
40 40 2 2 2 2 2 2 2 2 2 2 2 2 2 2 2 2 2 2 2 2 2 2 2 2 2 2 2 2 2 2 2 2 2 2 2 12 12 12 12 12 12 12 12 12 12 12 12 12 13 13 13 13 13 13 13 13 13 13 13 13 13 13 13 13 13 13 13 13 13 13 13 13 13 13 13 13 13 13 13 13 13 13 13 13 13 13 13 13 13 13 13 13 22 22 22 22 22 
40 40 2 2 2 2 2 2 2 2 2 2 2 2 2 2 2 2 2 2 2 2 2 2 2 2 2 2 2 2 2 2 2 2 2 2 2 12 12 12 12 12 12 12 12 12 12 12 12 12 13 13 13 13 13 13 13 13 13 13 13 13 13 13 13 13 13 13 13 13 13 13 13 13 13 13 13 13 13 13 13 13 13 13 13 13 13 13 13 13 13 13 13 13 22 22 22 22 22 
40 40 2 2 2 2 2 2 2 2 2 2 2 2 2 2 2 2 2 2 2 2 2 2 2 2 2 2 2 2 2 2 2 2 2 2 2 12 12 12 12 12 12 12 12 12 12 12 12 12 13 13 13 13 13 13 13 13 13 13 13 13 13 13 13 13 13 13 13 13 13 13 13 13 13 13 13 13 13 13 13 13 13 13 13 13 13 13 13 13 13 13 13 13 22 22 22 22 22 
40 40 2 2 2 2 2 2 2 2 2 2 2 2 2 2 2 2 2 2 2 2 2 2 2 2 2 2 2 2 2 2 2 2 2 2 2 12 12 12 12 12 12 12 12 12 12 12 12 12 13 13 13 13 13 13 13 13 13 13 13 13 13 13 13 13 13 13 13 13 13 13 13 13 13 13 13 13 13 13 13 13 13 13 13 13 13 13 13 13 13 13 13 13 22 22 22 22 22 
40 40 2 2 2 2 2 2 2 2 2 2 2 2 2 2 2 2 2 2 2 2 2 2 2 2 2 2 2 2 2 2 2 2 2 2 2 12 12 12 12 12 12 12 12 12 12 12 12 12 13 13 13 13 13 13 13 13 13 13 13 13 13 13 13 13 13 13 13 13 13 13 13 13 13 13 13 13 13 13 13 13 13 13 13 13 13 13 13 13 13 13 13 13 22 22 22 22 22 
40 40 17 17 17 17 17 17 17 17 17 17 17 17 17 17 17 17 17 17 17 17 17 17 17 17 17 17 17 17 12 12 12 12 12 12 12 12 12 12 12 12 12 12 12 12 12 12 12 12 13 13 13 13 13 13 13 13 13 13 13 13 13 13 13 13 13 13 13 13 13 13 13 13 13 13 13 13 13 13 13 13 13 13 13 13 13 13 13 13 13 13 13 13 22 22 22 22 22 
40 40 17 17 17 17 17 17 17 17 17 17 17 17 17 17 17 17 17 17 17 17 17 17 17 17 17 17 17 17 12 12 12 12 12 12 12 12 12 12 12 12 12 12 12 12 12 12 12 12 13 13 13 13 13 13 13 13 13 13 13 13 13 13 13 13 13 13 13 13 13 13 13 13 13 13 13 13 13 13 13 13 13 13 13 13 13 13 13 13 13 13 13 13 22 22 22 22 22 
40 40 17 17 17 17 17 17 17 17 17 17 17 17 17 17 17 17 17 17 17 17 17 17 17 17 17 17 17 17 12 12 12 12 12 12 12 12 12 12 12 12 12 12 12 12 12 12 12 12 13 13 13 13 13 13 13 13 13 13 13 13 13 13 13 13 13 13 13 13 13 13 13 13 13 13 13 13 13 13 13 13 13 13 13 13 13 13 13 13 13 13 13 13 22 22 22 22 22 
40 40 17 17 17 17 17 17 17 17 17 17 17 17 17 17 17 17 17 17 17 17 17 17 17 17 17 17 17 17 12 12 12 12 12 12 12 12 12 12 12 12 12 12 12 12 12 12 12 12 13 13 13 13 13 13 13 13 13 13 13 13 13 13 13 13 13 13 13 13 13 13 13 13 13 13 13 13 13 13 13 13 13 13 13 13 13 13 13 13 13 13 13 13 22 22 22 22 22 
40 40 17 17 17 17 17 17 17 17 17 17 17 17 17 17 17 17 17 17 17 17 17 17 17 17 17 17 17 17 12 12 12 12 12 12 12 12 12 12 12 12 12 12 12 12 12 12 12 12 13 13 13 13 13 13 13 13 13 13 13 13 13 13 13 13 13 13 13 13 13 13 13 13 13 13 13 13 13 13 13 13 13 13 13 13 13 13 13 13 13 13 13 13 22 22 22 22 22 
40 40 17 17 17 17 17 17 17 17 17 17 17 17 17 17 17 17 17 17 17 17 17 17 17 17 17 17 17 17 12 12 12 12 12 12 12 12 12 12 12 12 12 12 12 12 12 12 12 12 13 13 13 13 13 13 13 13 13 13 13 13 13 13 13 13 13 13 13 13 13 13 13 13 13 13 13 13 13 13 13 13 13 13 13 13 13 13 13 13 13 13 13 13 22 22 22 22 22 
40 40 17 17 17 17 17 17 17 17 17 17 17 17 17 17 17 17 17 17 17 17 17 17 17 17 17 17 17 17 12 12 12 12 12 12 12 12 12 12 12 12 12 12 12 12 12 12 12 12 13 13 13 13 13 13 13 13 13 13 13 13 13 13 13 13 13 13 13 13 13 13 13 13 13 13 13 13 13 13 13 13 13 13 13 13 13 13 13 13 13 13 13 13 22 22 22 22 22 
40 40 2 2 2 2 2 2 2 2 2 2 2 2 2 2 2 2 2 2 2 2 2 2 2 2 2 2 2 2 2 2 2 2 2 2 2 13 13 13 13 13 13 13 13 13 13 13 13 13 13 13 13 13 13 13 13 13 13 13 13 13 13 13 13 13 13 13 13 13 13 13 13 13 13 13 13 13 13 13 13 13 13 13 13 13 13 13 13 13 13 13 13 13 22 22 22 22 22 
40 40 2 2 2 2 2 2 2 2 2 2 2 2 2 2 2 2 2 2 2 2 2 2 2 2 2 2 2 2 2 2 2 2 2 2 2 13 13 13 13 13 13 13 13 13 13 13 13 13 13 13 13 13 13 13 13 13 13 13 13 13 13 13 13 13 13 13 13 13 13 13 13 13 13 13 13 13 13 13 13 13 13 13 13 13 13 13 13 13 13 13 13 13 22 22 22 22 22 
40 40 2 2 2 2 2 2 2 2 2 2 2 2 2 2 2 2 2 2 2 2 2 2 2 2 2 2 2 2 2 2 2 2 2 2 2 13 13 13 13 13 13 13 13 13 13 13 13 13 13 13 13 13 13 13 13 13 13 13 13 13 13 13 13 13 13 13 13 13 13 13 13 13 13 13 13 13 13 13 13 13 13 13 13 13 13 13 13 13 13 13 13 13 22 22 22 22 22 
40 40 2 2 2 2 2 2 2 2 2 2 2 2 2 2 2 2 2 2 2 2 2 2 2 2 2 2 2 2 2 2 2 2 2 2 2 13 13 13 13 13 13 13 13 13 13 13 13 13 13 13 13 13 13 13 13 13 13 13 13 13 13 13 13 13 13 13 13 13 13 13 13 13 13 13 13 13 13 13 13 13 13 13 13 13 13 13 13 13 13 13 13 13 22 22 22 22 22 
40 40 2 2 2 2 2 2 2 2 2 2 2 2 2 2 2 2 2 2 2 2 2 2 2 2 2 2 2 2 2 2 2 2 2 2 2 13 13 13 13 13 13 13 13 13 13 13 13 13 13 13 13 13 13 13 13 13 13 13 13 13 13 13 13 13 13 13 13 13 13 13 13 13 13 13 13 13 13 13 13 13 13 13 13 13 13 13 13 13 13 13 13 13 22 22 22 22 22 
40 40 2 2 2 2 2 2 2 2 2 2 2 2 2 2 2 2 2 2 2 2 2 2 2 2 2 2 2 2 2 2 2 2 2 2 2 13 13 13 13 13 13 13 13 13 13 13 13 13 13 13 13 13 13 13 13 13 13 13 13 13 13 13 13 13 13 13 13 13 13 13 13 13 13 13 13 13 13 13 13 13 13 13 13 13 13 13 13 13 13 13 13 13 22 22 22 22 22 
40 40 2 2 2 2 2 2 2 2 2 2 2 2 2 2 2 2 2 2 2 2 2 2 2 2 2 2 2 2 2 2 2 2 2 2 2 13 13 13 13 13 13 13 13 13 13 13 13 13 13 13 13 13 13 13 13 13 13 13 13 13 13 13 13 13 13 13 13 13 13 13 13 13 13 13 13 13 13 13 13 13 13 13 13 13 13 13 13 13 13 13 13 13 22 22 22 22 22 
40 40 2 2 2 2 2 2 2 2 2 2 2 2 2 2 2 2 2 2 2 2 2 2 2 2 2 2 2 2 2 2 2 2 2 2 2 13 13 13 13 13 13 13 13 13 13 13 13 13 13 13 13 13 13 13 13 13 13 13 13 13 13 13 13 13 13 13 13 13 13 13 13 13 13 13 13 13 13 13 13 13 13 13 13 13 13 13 13 13 13 13 13 13 22 22 22 22 22 
40 40 2 2 2 2 2 2 2 2 2 2 2 2 2 2 2 2 2 2 2 2 2 2 2 2 2 2 2 2 2 2 2 2 2 2 2 13 13 13 13 13 13 13 13 13 13 13 13 13 13 13 13 13 13 13 13 13 13 13 13 13 13 13 13 13 13 13 13 13 13 13 13 13 13 13 13 13 13 13 13 13 13 13 13 13 13 13 13 13 13 13 13 13 22 22 22 22 22 
40 40 2 2 2 2 2 2 2 2 2 2 2 2 2 2 2 2 2 2 2 2 2 2 2 2 2 2 2 2 2 2 2 2 2 2 2 13 13 13 13 13 13 13 13 13 13 13 13 13 13 13 13 13 13 13 13 13 13 13 13 13 13 13 13 13 13 13 13 13 13 13 13 13 13 13 13 13 13 13 13 13 13 13 13 13 13 13 13 13 13 13 13 13 22 22 22 22 22 
40 40 2 2 2 2 2 2 2 2 2 2 2 2 2 2 2 2 2 2 2 2 2 2 2 2 2 2 2 2 2 2 2 2 2 2 2 13 13 13 13 13 13 13 13 13 13 13 13 13 13 13 13 13 13 13 13 13 13 13 13 13 13 13 13 13 13 13 13 13 13 13 13 13 13 13 13 13 13 13 13 13 13 13 13 13 13 13 13 13 13 13 13 13 22 22 22 22 22 
40 40 2 2 2 2 2 2 2 2 2 2 2 2 2 2 2 2 2 2 2 2 2 2 2 2 2 2 2 2 2 2 2 2 2 2 2 13 13 13 13 13 13 13 13 13 13 13 13 13 13 13 13 13 13 13 13 13 13 13 13 13 13 13 13 13 13 13 13 13 13 13 13 13 13 13 13 13 13 13 13 13 13 13 13 13 13 13 13 13 13 13 13 13 22 22 22 22 22 
40 40 2 2 2 2 2 2 2 2 2 2 2 2 2 2 2 2 2 2 2 2 2 2 2 2 2 2 2 2 2 2 2 2 2 2 2 13 13 13 13 13 13 13 13 13 13 13 13 13 13 13 13 13 13 13 13 13 13 13 13 13 13 13 13 13 13 13 13 13 13 13 13 13 13 13 13 13 13 13 13 13 13 13 13 13 13 13 13 13 13 13 13 13 22 22 22 22 22 
40 40 2 2 2 2 2 2 2 2 2 2 2 2 2 2 2 2 2 2 2 2 2 2 2 2 2 2 2 2 2 2 2 2 2 2 2 13 13 13 13 13 13 13 13 13 13 13 13 13 13 13 13 13 13 13 13 13 13 13 13 13 13 13 13 13 13 13 13 13 13 13 13 13 13 13 13 13 13 13 13 13 13 13 13 13 13 13 13 13 13 13 13 13 22 22 22 22 22 
40 40 2 2 2 2 2 2 2 2 2 2 2 2 2 2 2 2 2 2 2 2 2 2 2 2 2 2 2 2 2 2 2 2 2 2 2 13 13 13 13 13 13 13 13 13 13 13 13 13 13 13 13 13 13 13 13 13 13 13 13 13 13 13 13 13 13 13 13 13 13 13 13 13 13 13 13 13 13 13 13 13 13 13 13 13 13 27 27 27 27 27 27 27 22 22 22 22 22 
40 11 11 11 11 11 11 11 11 11 11 11 11 11 11 11 11 11 11 11 11 11 11 11 11 11 11 11 11 11 11 11 11 11 11 11 11 13 13 13 13 13 13 13 13 13 13 13 13 13 13 13 13 13 13 13 13 13 13 13 13 13 13 13 13 13 13 13 13 13 13 13 13 13 13 13 13 13 13 13 13 13 13 13 13 27 27 27 27 27 27 27 27 27 22 22 22 22 22 
40 11 11 11 11 11 11 11 11 11 11 11 11 11 11 11 11 11 11 11 11 11 11 11 11 11 11 11 11 11 11 11 11 11 11 11 11 13 13 13 13 13 13 13 13 13 13 13 13 13 13 13 13 13 13 13 13 13 13 13 13 13 13 13 13 13 13 13 13 13 13 13 13 13 13 13 13 13 13 13 13 13 13 13 13 27 27 27 27 27 27 27 27 27 22 22 22 22 22 
40 11 11 11 11 11 11 11 11 11 11 11 11 11 11 11 11 11 11 11 11 11 11 11 11 11 11 11 11 11 11 11 11 11 11 11 11 13 13 13 13 13 13 13 13 13 13 13 13 13 13 13 13 13 13 13 13 13 13 13 13 13 13 13 13 13 13 13 13 13 13 13 13 13 13 13 13 13 13 13 13 13 13 13 13 27 27 27 27 27 27 27 27 27 22 22 22 22 22 
40 11 11 11 11 11 11 11 11 11 11 11 11 11 11 11 11 11 11 11 11 11 11 11 11 11 11 11 11 11 11 11 11 11 11 11 11 13 13 13 13 13 13 13 13 13 13 13 13 13 13 13 13 13 13 13 13 13 13 13 13 13 13 13 13 13 13 13 13 13 13 13 13 13 13 13 13 13 13 13 13 13 13 13 13 27 27 27 27 27 27 27 27 27 22 22 22 22 22 
40 11 11 11 11 11 11 11 11 11 11 11 11 11 11 11 11 11 11 11 11 11 11 11 11 11 11 11 11 11 11 11 11 11 11 11 11 11 11 11 11 11 11 11 11 11 11 11 11 38 38 38 38 38 38 38 38 38 38 38 13 13 13 13 13 13 13 13 13 13 13 13 13 13 13 13 13 13 13 13 13 13 13 13 13 27 27 27 27 27 27 27 27 27 22 22 22 22 22 
40 11 11 11 11 11 11 11 11 11 11 11 11 11 11 11 11 11 11 11 11 11 11 11 11 11 11 11 11 11 11 11 11 11 11 11 11 11 11 11 11 11 11 11 11 11 11 11 11 38 38 38 38 38 38 38 38 38 38 38 13 13 13 13 13 13 13 13 13 13 13 13 13 13 13 13 13 13 13 13 13 13 13 13 13 27 27 27 27 27 27 27 27 27 22 22 22 22 22 
40 11 11 11 11 11 11 11 11 11 11 11 11 11 11 11 11 11 11 11 11 11 11 11 11 11 11 11 11 11 11 11 11 11 11 11 11 11 11 11 11 11 11 11 11 11 11 11 11 38 38 38 38 38 38 38 38 38 38 38 13 13 13 13 13 13 13 13 13 13 13 13 13 13 13 13 13 13 13 13 27 27 27 27 27 27 27 27 27 27 27 27 27 27 22 22 22 22 22 
40 11 11 11 11 11 11 11 11 11 11 11 11 11 11 11 11 11 11 11 11 11 11 11 11 11 11 11 11 11 11 11 11 11 11 11 11 11 11 11 11 11 11 11 11 11 11 11 11 38 38 38 38 38 38 38 38 38 38 38 38 38 38 38 38 38 38 38 38 13 13 13 13 13 13 13 13 13 13 13 27 27 27 27 27 27 27 27 27 27 27 27 27 27 22 22 22 22 22 
40 40 11 11 11 11 11 11 11 11 11 11 11 11 11 11 11 11 11 11 11 11 11 11 11 11 11 11 11 11 11 11 11 11 11 11 11 11 11 11 11 11 11 11 11 11 11 11 11 11 11 38 38 38 38 38 38 38 38 38 38 38 38 38 38 38 38 38 38 13 13 13 13 13 13 13 13 13 13 13 27 27 27 27 27 27 27 27 27 27 27 27 27 27 22 22 22 22 22 
40 40 11 11 11 11 11 11 11 11 11 11 20 20 20 33 33 33 20 20 11 11 11 11 11 11 11 11 11 11 11 11 11 11 11 11 11 11 11 11 11 11 11 11 11 11 11 11 11 11 11 11 38 38 38 38 38 38 38 38 38 38 38 38 38 38 38 38 38 13 13 13 13 13 13 13 13 13 13 13 27 27 27 27 27 27 27 27 27 27 27 27 27 39 39 39 39 39 39 
40 40 11 11 11 11 11 11 11 11 11 11 20 20 33 11 11 11 33 20 11 11 11 11 11 11 11 11 11 11 11 11 11 11 11 11 11 11 11 11 11 11 11 11 11 11 11 11 11 11 11 11 38 38 38 38 38 38 38 38 38 38 38 38 38 38 38 38 38 13 13 13 13 13 13 13 13 13 13 13 27 27 27 27 27 27 27 27 27 27 27 27 27 39 39 39 39 39 39 
40 40 11 11 11 11 11 11 11 11 11 11 20 33 11 11 11 11 11 33 11 11 11 11 11 11 11 11 11 11 11 11 11 11 11 11 11 11 11 11 11 11 11 11 11 11 11 11 11 11 11 11 38 38 38 38 38 38 38 38 38 38 38 38 38 38 38 38 38 13 13 13 13 13 13 13 13 13 13 13 27 27 27 27 27 27 27 27 27 27 27 27 27 39 39 39 39 39 39 
40 40 11 11 11 11 11 11 11 11 11 11 20 33 11 11 33 33 11 33 11 11 11 11 11 11 11 11 11 11 11 11 11 11 11 11 11 11 11 11 11 11 11 11 11 11 11 11 11 11 11 11 11 38 38 38 38 38 38 38 38 38 38 38 38 38 38 38 38 38 13 13 13 13 13 13 13 13 13 13 27 27 27 27 27 27 27 27 27 27 27 27 27 27 27 27 27 27 27 
40 40 11 11 11 11 11 11 11 11 11 11 20 33 11 11 33 11 11 33 11 11 11 11 11 11 11 11 11 11 11 11 11 11 11 11 11 11 11 11 11 11 11 11 11 11 11 11 11 11 11 11 11 11 38 38 38 38 38 38 13 13 13 13 13 13 13 13 13 13 13 13 13 13 13 13 13 13 13 13 27 27 27 27 27 27 27 27 27 27 27 27 27 27 27 27 27 27 27 
40 40 11 11 11 11 11 11 11 11 11 11 33 33 33 33 33 33 11 33 11 11 11 11 11 11 11 11 11 11 11 11 11 11 11 11 11 11 11 11 11 11 11 11 11 11 11 11 11 11 11 11 11 11 11 11 38 38 38 38 13 13 13 13 13 13 13 13 13 13 13 13 13 13 13 13 13 13 13 13 27 27 27 27 27 27 27 27 27 27 27 27 27 27 27 27 27 27 27 
40 40 11 11 11 11 11 11 11 11 11 11 20 33 11 11 11 11 11 33 11 11 11 11 11 11 11 11 11 11 33 33 33 33 33 33 33 33 33 33 33 11 11 11 11 11 11 11 11 11 11 11 11 11 11 11 38 38 38 38 13 13 13 13 13 13 13 13 13 13 33 33 33 33 33 33 33 33 33 33 27 27 27 27 27 27 27 27 27 27 27 27 27 27 27 27 27 27 27 
40 40 11 11 11 11 11 11 11 11 11 11 20 33 33 33 11 11 33 11 11 11 11 11 11 11 11 11 11 33 33 33 33 33 33 33 33 33 33 33 33 11 11 11 11 11 11 11 11 11 11 11 11 11 11 11 11 11 38 38 13 13 13 13 13 13 13 13 13 13 33 33 33 33 33 33 33 33 33 33 27 27 27 27 27 27 27 27 27 27 27 27 27 27 27 27 27 27 27 
40 40 11 11 11 11 11 11 11 11 11 11 11 11 11 33 33 33 11 11 11 11 11 11 11 11 11 11 11 33 33 33 33 33 33 33 33 33 33 33 33 33 11 20 20 20 11 11 20 11 11 11 11 11 11 11 11 11 11 38 13 13 13 13 13 13 13 13 13 13 33 33 33 33 33 33 33 33 33 33 27 27 27 27 27 27 27 27 27 27 27 27 27 27 27 27 27 27 27 
40 40 11 11 11 11 11 11 11 11 11 11 11 11 11 20 33 11 11 11 11 11 11 11 11 11 11 11 33 33 33 33 33 33 33 33 33 33 33 33 33 33 11 20 20 20 11 20 20 20 20 11 11 11 11 11 11 11 11 38 13 13 13 13 13 13 13 13 13 13 33 33 33 33 33 33 33 33 33 33 27 27 27 27 27 27 27 27 27 27 27 27 27 27 27 27 27 27 27 
40 40 11 11 11 11 11 11 11 11 11 11 11 11 11 20 33 33 11 11 11 11 11 11 11 11 11 11 33 33 33 33 33 33 33 33 33 33 33 33 33 33 11 20 20 20 11 20 20 20 20 11 11 11 11 11 11 11 11 11 13 13 13 13 13 13 13 13 13 13 33 33 33 33 33 33 33 33 33 33 27 27 27 27 27 27 27 27 27 27 27 27 27 27 27 27 27 27 27 
40 40 11 11 11 11 11 11 11 11 11 11 11 11 11 33 33 11 11 11 11 11 11 11 11 11 11 33 33 33 33 33 33 33 33 33 33 33 33 33 33 33 11 11 20 20 20 20 20 20 20 20 20 11 11 11 11 11 11 11 13 13 13 13 13 13 13 13 13 13 33 33 33 33 33 33 33 33 33 33 27 27 27 27 27 27 27 27 27 27 27 27 27 27 27 27 27 27 27 
40 40 11 11 11 11 11 11 11 11 11 11 11 11 33 33 11 11 11 11 11 11 11 11 11 11 33 33 33 33 33 33 33 33 33 33 33 33 33 33 33 33 33 11 20 20 20 20 20 20 20 20 20 11 11 11 11 11 11 11 13 13 13 13 13 13 13 13 13 13 33 33 33 33 33 33 33 33 33 33 27 27 27 27 27 27 27 27 27 27 27 27 27 27 27 27 27 27 27 
40 40 11 11 11 11 11 11 11 11 11 11 11 11 33 11 11 11 11 11 11 11 11 11 11 11 33 33 33 33 33 33 33 33 33 33 33 33 33 33 33 33 33 11 20 20 20 20 20 20 20 20 20 20 11 11 11 11 11 11 13 13 13 13 13 13 13 13 13 13 33 33 33 33 33 33 33 33 33 33 27 27 27 27 27 27 27 27 27 27 27 27 27 27 27 27 27 27 27 
40 40 11 11 11 11 11 11 11 11 11 11 11 11 11 11 11 11 11 11 11 11 11 11 11 11 33 33 33 33 33 33 33 33 33 33 33 33 33 33 33 33 33 11 20 20 20 20 20 20 20 20 20 20 20 11 11 11 11 11 13 13 13 13 13 13 13 13 13 13 33 33 33 33 33 33 33 33 33 33 27 27 27 27 27 27 27 27 27 27 27 27 27 27 27 27 27 27 27 
40 40 11 11 11 11 11 11 11 11 11 11 11 11 11 11 11 11 11 11 11 11 11 11 11 11 33 33 33 33 33 33 33 33 33 33 33 33 33 33 33 33 33 11 20 20 20 20 20 20 20 20 20 20 20 11 11 11 11 11 13 13 13 13 13 13 13 13 13 13 33 33 33 33 33 33 33 33 33 33 27 27 27 27 27 27 27 27 27 27 27 27 27 27 27 27 27 27 27 
40 40 11 11 11 11 11 11 11 11 11 11 11 11 11 11 11 11 11 11 11 11 11 11 11 11 11 33 33 33 33 33 33 33 33 33 33 33 33 33 33 33 11 11 20 20 20 20 20 20 20 20 20 20 20 11 11 11 11 11 33 33 33 33 33 33 33 33 33 33 33 33 33 33 33 33 33 33 33 21 21 21 21 21 21 21 21 21 21 27 27 27 27 27 27 27 27 27 27 
40 40 11 11 11 11 11 11 11 11 11 11 11 11 11 11 11 11 11 11 11 11 11 11 11 11 11 33 33 33 33 33 33 33 33 33 33 33 33 33 11 11 11 11 11 11 11 11 11 11 11 11 11 11 11 11 11 11 11 11 33 33 33 33 33 33 33 33 33 33 33 33 33 33 33 33 33 33 33 21 21 21 21 21 21 21 21 21 21 27 27 27 27 27 27 27 27 27 27 
40 40 11 11 11 11 11 11 11 11 11 11 11 11 11 11 11 11 11 11 11 11 11 11 11 11 11 11 33 33 33 33 33 11 11 11 11 11 11 11 11 11 11 11 11 11 11 11 11 11 11 11 11 11 11 11 11 11 11 11 33 33 33 33 33 33 33 33 33 33 33 33 33 33 33 33 33 33 33 21 21 21 21 21 21 21 21 21 21 27 27 27 27 27 27 27 27 27 27 
40 40 11 11 11 11 11 11 11 11 11 11 11 11 11 11 11 11 11 11 11 11 11 11 11 11 11 11 11 11 11 11 11 11 11 11 11 11 11 11 11 11 11 11 11 11 11 11 11 11 11 11 11 11 11 11 11 11 11 11 33 33 33 33 33 33 33 33 33 33 33 33 33 33 33 33 33 33 33 21 21 21 21 21 21 21 21 21 21 27 27 27 27 27 27 27 27 27 27 
40 40 11 11 11 11 11 11 11 11 11 11 11 11 11 11 11 11 11 11 11 11 11 11 11 11 11 11 11 11 11 11 11 11 11 11 11 11 11 11 11 11 11 11 11 11 11 11 11 11 11 11 11 11 11 11 11 11 11 11 33 33 33 33 33 33 33 33 33 33 33 33 33 33 33 33 33 33 33 21 21 21 21 21 21 21 21 21 21 27 27 27 27 27 27 27 27 27 27 
40 40 11 11 11 11 11 11 11 11 11 11 11 11 11 11 11 11 11 11 11 11 11 11 11 11 11 11 11 11 11 11 11 11 11 11 11 11 11 11 11 11 11 11 11 11 11 11 11 11 11 11 11 11 11 11 11 11 11 11 33 33 33 33 33 33 33 33 33 33 33 33 33 33 33 33 33 33 33 21 21 21 21 21 21 21 21 21 21 27 27 27 27 27 27 27 27 27 27 
40 40 11 11 11 11 11 11 11 11 11 11 11 11 11 11 11 11 11 11 11 11 11 11 11 11 11 11 11 11 11 11 11 11 11 11 11 11 11 11 11 11 11 11 11 11 11 11 11 11 11 11 11 11 11 11 11 11 11 11 33 33 33 33 33 33 33 33 33 33 33 33 33 33 33 33 33 33 33 21 21 21 21 21 21 21 21 21 21 27 27 27 27 27 27 27 27 27 27 
40 40 11 11 11 11 11 11 11 11 11 11 11 11 11 11 11 11 11 11 11 11 11 11 11 11 11 11 11 11 11 11 11 11 11 11 11 11 11 11 11 11 11 11 11 11 11 11 11 11 11 11 11 11 11 11 11 11 11 11 33 33 33 33 33 33 33 33 33 33 33 33 33 33 33 33 33 33 33 21 21 21 21 21 21 21 21 21 21 27 27 27 27 27 27 27 27 27 27 
40 40 11 11 11 11 11 11 11 11 11 11 11 11 11 11 11 11 11 11 11 11 11 11 11 11 11 11 11 11 11 11 11 11 11 11 11 11 11 11 11 11 11 11 11 11 11 11 11 11 11 11 11 11 11 11 11 11 11 11 33 33 33 33 33 33 33 33 33 33 33 33 33 33 33 33 33 33 33 21 21 21 21 21 21 21 21 21 21 27 27 27 27 27 27 27 27 27 27 
40 40 11 11 11 11 11 11 11 11 11 11 11 11 11 11 11 11 11 11 11 11 11 11 11 11 11 11 11 11 11 27 27 27 27 27 27 27 27 27 27 27 27 27 27 27 27 8 8 8 8 8 8 27 27 27 27 27 8 8 33 33 33 33 33 33 33 33 33 33 33 33 33 33 33 33 33 33 33 21 21 21 21 21 21 21 21 21 21 27 27 27 27 27 27 27 27 27 27 
40 40 38 38 38 38 38 38 38 38 38 38 38 38 38 38 38 38 38 38 38 38 38 38 38 38 38 38 27 27 27 6 6 6 6 6 6 6 27 27 27 27 27 27 38 38 27 8 8 8 8 8 8 27 38 38 38 27 8 8 8 8 8 8 8 8 8 8 33 33 33 33 33 33 33 33 33 33 33 21 21 21 21 21 21 21 21 21 21 27 27 27 27 27 27 27 27 27 27 
40 40 38 38 38 38 38 38 38 38 38 38 38 38 38 38 38 38 38 38 38 38 38 38 38 38 38 38 27 27 6 6 38 38 38 38 38 6 6 27 27 27 27 38 6 38 27 8 8 8 8 8 8 27 38 6 38 27 8 8 8 8 8 8 8 8 8 8 33 33 33 33 33 33 33 33 33 33 33 21 21 21 21 21 21 21 21 21 21 27 27 27 27 27 27 27 27 27 27 
40 40 38 38 38 38 38 38 38 38 38 38 38 38 38 38 38 38 38 38 38 38 38 38 38 38 38 38 38 27 6 38 38 38 38 38 38 38 6 6 38 38 38 38 6 38 27 27 27 27 27 27 27 27 38 6 38 27 27 27 27 8 8 8 8 8 8 8 33 33 33 33 33 33 33 33 33 33 33 21 21 21 21 21 21 21 21 21 21 27 27 27 27 27 27 27 27 27 27 
40 40 38 38 38 38 38 38 38 38 38 38 38 38 38 38 38 38 38 38 38 38 38 38 38 38 38 38 38 27 6 38 38 38 38 38 38 38 38 38 38 38 38 38 6 38 38 38 38 38 38 38 38 38 38 6 38 38 38 38 27 8 8 8 8 8 8 8 8 33 33 33 33 33 33 33 33 33 33 21 21 21 21 21 21 21 21 21 21 27 27 27 27 27 27 27 27 27 27 
40 40 38 38 38 38 38 38 38 38 38 38 38 38 38 38 38 38 38 38 38 38 38 38 38 38 38 38 38 27 6 38 38 38 38 38 38 38 38 38 38 6 6 6 6 6 6 6 6 38 38 38 6 6 6 6 6 6 6 38 27 8 8 8 8 8 8 8 8 33 33 33 33 33 33 33 33 33 33 33 33 33 33 33 33 33 33 33 33 27 27 27 27 27 27 27 27 27 27 
40 40 38 38 38 38 38 38 38 38 38 38 38 38 38 38 38 38 38 38 38 38 38 38 38 38 38 38 38 27 6 38 38 38 38 38 38 38 38 38 38 38 38 38 6 38 38 38 38 38 38 38 38 38 38 6 38 38 38 38 27 8 8 8 8 8 33 33 33 33 33 33 33 33 33 33 33 33 33 33 33 33 33 33 33 33 33 33 33 27 27 27 27 27 27 27 27 27 27 
40 40 38 38 38 38 38 38 38 38 38 38 38 38 38 38 38 38 38 38 38 38 38 38 38 38 38 38 38 27 6 38 38 38 38 38 38 38 38 38 27 27 27 38 6 38 27 27 27 27 27 27 27 27 38 6 38 27 27 27 27 8 8 8 8 8 33 33 33 33 33 33 33 33 33 33 33 33 33 33 33 33 33 33 33 33 33 33 33 27 27 27 27 27 27 27 27 27 27 
40 40 38 38 38 38 38 38 38 38 38 38 38 38 38 38 38 38 38 38 38 38 38 38 38 38 38 38 38 27 6 38 38 38 38 38 38 38 6 6 27 17 27 38 6 38 27 32 32 32 32 32 32 27 38 6 38 27 33 33 33 33 33 33 33 33 33 33 33 33 33 33 33 33 33 33 33 33 33 33 33 33 33 33 33 33 33 33 33 27 27 27 27 27 27 27 27 27 27 
40 40 38 38 38 38 38 38 38 38 38 38 38 38 38 38 38 38 38 38 38 38 38 38 38 38 38 38 38 27 6 6 38 38 38 38 38 6 6 27 27 17 27 38 38 38 27 32 32 32 32 32 32 27 38 38 38 27 33 33 33 33 33 33 33 33 33 33 33 33 33 33 33 33 33 33 33 33 33 33 33 33 33 33 33 33 33 33 33 27 27 27 27 27 27 27 27 27 27 
40 40 38 38 38 38 38 38 38 38 38 38 38 38 38 38 38 38 38 38 38 38 38 38 38 38 38 38 38 27 27 6 6 6 6 6 6 6 27 27 17 17 27 27 27 27 27 32 32 32 32 32 32 27 27 27 27 27 33 33 33 33 33 33 33 33 33 33 33 33 33 33 33 33 33 33 33 33 33 33 33 33 33 33 33 33 33 33 33 27 27 27 27 27 27 27 27 27 27 
40 40 38 38 38 38 38 38 38 38 38 38 38 38 38 38 38 38 38 38 38 38 38 38 38 38 38 38 38 38 27 27 27 27 27 27 27 27 27 17 17 17 17 17 17 17 17 32 32 32 32 32 32 32 32 32 32 32 33 33 33 33 33 33 33 33 33 33 33 33 33 33 33 33 33 33 33 33 33 33 33 33 33 33 33 33 33 33 33 27 27 27 27 27 27 27 27 27 27 
40 40 38 38 38 38 38 38 38 38 38 38 38 38 38 38 38 38 38 38 38 38 38 38 38 38 38 38 38 38 32 32 32 32 32 32 32 32 32 32 32 32 32 32 32 32 32 32 32 32 32 32 32 32 32 32 32 32 33 33 33 33 33 33 33 33 33 33 33 33 33 33 33 33 33 33 33 33 33 33 33 33 33 33 33 33 33 33 33 27 27 27 27 27 27 27 27 27 27 
40 40 38 38 38 38 38 38 38 38 38 38 38 38 38 38 38 38 38 38 38 38 38 38 38 38 38 38 38 38 32 32 32 32 32 32 32 32 32 32 32 32 32 32 32 32 32 32 32 32 32 32 32 32 32 32 32 32 33 33 33 33 33 33 33 33 33 33 33 33 33 33 33 33 33 33 33 33 33 33 33 33 33 33 33 33 33 33 33 27 27 27 27 27 27 27 27 27 27 
40 40 38 38 38 38 38 38 38 38 38 38 38 38 38 38 38 38 38 38 38 38 38 38 38 38 38 38 38 38 32 32 32 32 32 32 32 32 32 32 32 32 32 32 32 32 32 32 32 32 32 32 32 32 32 32 32 32 33 33 33 33 33 33 33 33 33 33 33 33 33 33 33 33 33 33 33 33 33 33 33 33 33 33 33 33 33 33 33 27 27 27 27 27 27 27 27 27 27 
40 40 38 38 38 38 38 38 38 38 38 38 38 38 38 38 38 38 38 38 38 38 38 38 38 38 38 38 38 38 32 32 32 32 32 32 32 32 32 32 32 32 32 32 32 32 32 32 32 32 32 32 32 32 32 32 32 32 33 33 33 33 33 33 33 33 33 33 33 33 33 33 33 33 33 33 33 33 33 33 33 33 33 33 33 33 33 33 33 27 27 27 27 27 27 27 27 27 27 
40 40 38 38 38 38 38 38 38 38 38 38 38 38 38 38 38 38 38 38 38 38 38 38 38 38 38 38 38 38 32 32 32 32 32 32 32 32 32 32 32 32 32 32 32 32 32 32 32 32 32 32 32 32 32 32 32 32 33 33 33 33 33 33 33 33 33 33 33 33 33 33 33 33 33 33 33 33 33 33 33 33 33 33 33 33 33 33 33 27 27 27 27 27 27 27 27 27 27 
40 40 38 38 38 38 38 38 38 38 38 38 38 38 38 38 38 38 38 38 38 38 38 38 38 38 38 38 38 38 32 32 32 32 32 32 32 32 32 32 32 32 32 32 32 32 32 32 32 32 32 32 32 32 32 32 32 32 33 33 33 33 33 33 33 33 33 33 33 33 33 33 33 33 33 33 33 33 33 33 33 33 33 33 33 33 33 33 33 27 27 27 27 27 27 27 27 27 27 
40 40 38 38 38 38 38 38 38 38 38 38 38 38 38 38 38 38 38 38 38 38 38 38 38 38 38 38 38 38 32 32 32 32 32 32 32 32 32 32 32 32 32 32 32 32 32 32 32 32 32 32 32 32 32 32 32 32 32 32 32 32 32 32 32 32 33 33 33 33 33 33 33 33 33 33 33 33 33 33 33 33 33 33 33 33 33 33 33 27 27 27 27 27 27 27 27 27 27 
40 40 38 38 38 38 38 38 38 38 38 38 38 38 38 38 38 38 38 38 38 38 38 38 38 38 38 38 38 38 32 32 32 32 32 32 32 32 32 32 32 32 32 32 32 32 32 32 32 32 32 32 32 32 32 32 32 32 32 32 32 32 32 32 32 32 33 33 33 33 33 33 33 33 33 33 33 33 33 33 33 33 33 33 33 33 33 33 33 27 27 27 27 27 27 27 27 27 27 
40 40 38 38 38 38 38 38 38 38 38 38 38 38 38 38 38 38 38 38 38 38 38 38 38 38 38 38 38 38 32 32 32 32 32 32 32 32 32 32 32 32 32 32 32 32 32 32 32 32 32 32 32 32 32 32 32 32 32 32 32 32 32 32 32 32 33 33 33 33 33 33 33 33 33 33 33 33 33 33 33 33 33 33 33 33 33 33 33 27 27 27 27 27 27 27 27 27 27 
40 40 38 38 38 38 38 38 38 38 38 38 38 38 38 38 38 38 38 38 38 38 38 38 38 38 38 38 38 38 32 32 32 32 32 32 32 32 32 32 32 32 32 32 32 32 32 32 32 32 32 32 32 32 32 32 32 32 32 32 32 32 32 32 32 32 33 33 33 33 33 33 33 33 33 33 33 33 33 33 33 33 33 33 33 33 33 33 33 27 27 27 27 27 27 27 27 27 27 
40 40 38 38 38 38 38 38 38 38 38 38 38 38 38 38 38 38 38 38 38 38 38 38 38 38 38 38 38 38 32 32 32 32 32 32 32 32 32 32 32 32 32 32 32 32 32 32 32 32 32 32 32 32 32 32 32 32 32 32 32 32 32 32 32 32 33 33 33 33 33 33 33 33 33 33 33 33 33 33 33 33 33 33 33 33 33 33 33 27 27 27 27 27 27 27 27 27 27 
40 40 38 38 38 38 38 38 38 38 38 38 38 38 38 38 38 38 38 38 38 38 38 38 38 38 38 38 38 38 32 32 32 32 32 32 32 32 32 32 32 32 32 32 32 32 32 32 32 32 32 32 32 32 32 32 32 32 32 32 32 32 32 32 32 32 33 33 33 33 33 33 33 33 33 33 33 33 33 33 33 33 33 33 33 33 33 33 33 27 27 27 27 27 27 27 27 27 27 
40 40 38 38 38 38 38 38 38 38 38 38 38 38 38 38 38 38 38 38 38 38 38 38 38 38 38 38 38 38 32 32 32 32 32 32 32 32 32 32 32 32 32 32 32 32 32 32 32 32 32 32 32 32 32 32 32 32 32 32 32 32 32 32 32 32 33 33 33 33 33 33 33 33 33 33 33 33 33 33 33 33 33 33 33 33 33 33 33 27 27 27 27 27 27 27 27 27 27 
40 40 38 38 38 38 38 38 38 38 38 38 38 38 38 38 38 38 38 38 38 38 38 38 38 38 38 38 38 38 38 38 38 38 38 38 38 38 38 38 38 38 38 38 38 38 38 38 38 38 38 38 38 38 38 38 38 38 38 38 38 38 38 38 38 38 38 38 38 38 38 38 38 38 38 38 38 38 38 38 38 38 38 38 38 38 38 38 38 27 27 27 27 27 27 27 27 27 27 
40 40 38 38 38 38 38 38 38 38 38 38 38 38 38 38 38 38 38 38 38 38 38 38 38 38 38 38 38 38 38 38 38 38 38 38 38 38 38 38 38 38 38 38 38 38 38 38 38 38 38 38 38 38 38 38 38 38 38 38 38 38 38 38 38 38 38 38 38 38 38 38 38 38 38 38 38 38 38 38 38 38 38 38 38 38 38 38 38 27 27 27 27 27 27 27 27 27 27 
40 40 38 38 38 38 38 38 38 38 38 38 38 38 38 38 38 38 38 38 38 38 38 38 38 38 38 38 38 38 38 38 38 38 38 38 38 38 38 38 38 38 38 38 38 38 38 38 38 38 38 38 38 38 38 38 38 38 38 38 38 38 38 38 38 38 38 38 38 38 38 38 38 38 38 38 38 38 38 38 38 38 38 38 38 38 38 38 38 27 27 27 27 27 27 27 27 27 27 
40 40 40 40 40 40 40 40 40 40 40 40 40 40 40 40 40 40 40 40 40 40 40 40 40 40 40 40 40 40 40 40 40 40 40 40 40 40 40 40 40 40 40 40 40 40 40 40 40 40 40 40 40 40 40 40 40 40 40 40 40 40 40 40 40 40 40 40 40 40 40 40 40 40 40 40 40 40 40 40 40 40 40 40 40 40 40 40 40 40 40 40 40 40 40 40 40 40 40 
40 40 40 40 40 40 40 40 40 40 40 40 40 40 40 40 40 40 40 40 40 40 40 40 40 40 40 40 40 40 40 40 40 40 40 40 40 40 40 40 40 40 40 40 40 40 40 40 40 40 40 40 40 40 40 40 40 40 40 40 40 40 40 40 40 40 40 40 40 40 40 40 40 40 40 40 40 40 40 40 40 40 40 40 40 40 40 40 40 40 40 40 40 40 40 40 40 40 40